11111111111111111111111111111111
10000000000000000000000000000101
10000000000000000000000000000101
10000000000000000000000000000101
00000000000000000000000000000101
00000000000000000000000000000101
10000000000000000000000000000101
10000011111111111111111100000101
10000010000000000000000100000101
10000010000000000000000100000101
10000010000000000000000100000101
10000010000000000000000100000101
10000010000000000000000100000101
10000010000000111000000100000100
10000010000000000000000100000100
10000010000000000000000100000001
10000010000000000000000100000001
10000010000000000000000000000101
10000010000000000000000000000101
10000010000000000000000100000101
10000010000000000000000100000101
10000010000000000000000100000101
10000010000000000000000100000101
10000010000000000000000100000101
10000010000000000000000100000101
10000011111111111111111100000101
10000000000000000000000000000101
10000000000000000000000000000101
10000000000000000000000000000101
10000000000000000000000000000101
10100000000000000000000000000101
10000000000000000000000000000001
11111111111111111111111111111111